111111111111111
100000000000001
1C0000P000000E1
100000000000001
111111111111111