111111111111111111
1E0010000100100001
1000000100P0001001
10010CC0010CC0C011
100100000101010C01
100C01000C000000C1
111111111111111111